windows phone 8.1..........................
..........................
........##..##............
........##..##............
%%....%%##%%##%%....%%....
%%....%%##%%##%%....%%....
##%%%%##########%%%%##%%..
##%%%%##########%%%%##%%..
###&&###@@##@@####&&##%%..
########@@##@@########%%..
~~~~~~##########~~~~~~%%..
~~~~~~##########~~~~~~%%..
~~####&&###&&#######~~~~%%
~~#############&&###~~~~%%
######~~######~~######%%%%
######~~######~~######%%%%
####~~~~~~##~~~~~~####~~~~
####~~~~~~##~~~~~~####~~~~
%%~~~~%%%%%%%%%%~~~~%%~~%%
%%~~~~%%%%%%%%%%~~~~%%~~%%
..%%%%..........%%%%..%%..
..%%%%..........%%%%..%%..
..........................
...........####...........
...........#..#...........
...........#..#...........